#########      ############         ##########                                 
#       #      #          #         # s   s  #                                 
#       ########          #         #   s s  #                               
#   @           t     r   #         #  s     #                                 
#       ########          #         ##### ####                                 
#       #      #          #             # #                                    
#### ####      ############      ######## ########                             
   # #                           #               #                             
   # #                           # ############# #                             
   # #                           # #           # #                             
   # #                           # #        #### ####                          
#### #######      ################ ####     #       #                          
#  s s     #      #      r         r  #     #   !   #                          
#   s      ########  r        r       #     #### ####                           
#      a                 r !      r t #        # #                             
#          ########   r        r      ########## ##                            
#   l      #      #        r        r     s       #                            
############      #################################                            
                                                                               
                                                                               
                                                                               
